11 17 4 4 1 1 mapa.txt
##########      
#        #######
#              #
1              #
#              #
#              #
#        #######
#        #      
#        #      
##########      
